#^.^~****^*~~.~^~..~~~^~.^~.*~**.^^*^*^~..*^^..~^.
*#*~*.~^^^~~.*~*.**.~~^*^**.^~*^^.*^...^..^.**.~^*
^^#**~.*^*^..^**.~~~.~*.~^^~^~^.^~^*~**.~*^.^**.*.
*~~#~^.~*~^~^^*^**.~.*^^*~~^^*~.^.*^^*^.^.~~^^^*~.
*.^~#^.~^.^.^^*~^~~*^..^~^~~^.*^^..**.**~.~~^~*~**
^.^^~###~**.*~*^*~^*~~^.^.~.~^**~.^^^^*.~.~~~^^.^.
*~~.*.#~~~^*.^*~~~*^.^**^*^.^.^~~***^^*^.~^^.^^.~.
.~.*~~^#.**.~^^~**^.^.^~~~^.~.^~~^^.~^^.^^~.~.~.*^
.^^^~~*~#^.~.*~.~~..~*~^.~**~..^****~.*~^~~*~**^~^
^^^*^^**.##*.^^*^^^.*~*~^^~*~~.~****~~~~***.^^~~^~
..*^^^^^.^~#^~.^.^^~*~^*~**^*^.~~~*^.^^~**~*~.....
**.^~~~^~*~*#####*^~.^.*^^^~.^...~.**^^^^~^.~^~.~*
^*~.*.~*^.~.^^^^^#~.**~^.*^*.~~..^~~~*~*^.~~^*^*^^
~*^.^..**~**^*^~**#^~~*^*.*~..~^^***^.*~.^*^^^^.~.
*~^~^**^^*^^~^*~^^#~~~*^*~~~~*~^^^*~..~~~~~.*~^~*.
^.*.^*^**^^^~**.*#~^~~~^..~~~*~~^*~..^^.^~*.^~^~**
.***^..*^~~~~^~.#^~~.*.~^.^^*.***^~^.*....~.^.*~^^
^^~~~~.**.*.^^*#^~~^....*~*^~*^^.^~~~^*.~^^^~**^~~
^~~*^*.~.*^^^*^###.~*...~**^.^^~.^^.^..^.^**.^^..*
~^***~^.~.~^^^*~~~#*..^~^^.~^.~.**...~^~**~^~~**^~
~~~^~.^*.^*.~*.*~~^#.~*^^~~**.*.*.~^^^..^.~^.*.^~~
^^~...^.*~.^^**~^~*.#^~^~*....^.^^**~.*.^^*..~*~.*
^..^...~.~.*.~***~*~~##.~*~^^~~^~**^~~^*^^~*.~*^*^
*^.**^~*****.~~~..~^~.*#^*~^.^^*^..*~^.^.^*.^.~^^*
~...~*^....*^.*^^*...^#~~..^.*~.*~.*^.^*^*^.****^~
^..~***^.*^~~.****.~*^#~.^~*.~^*^~^.****~..~*..*^~
.~^~**~^^..~~~^..*~*.^*#~..^^*.~.*..*~~*~.^~.~*~~.
.***~..~**^.~.~.~*.~~**.#^.^~..~*~~~~*.**~~^..^.^^
~.*.~^*^*~^.~*..*~^~~.*.*#.*.*..^~.*~^^*.~^.^~^**^
.*^~^^*.^*.~*...*~~~*.**.~###*.*^.^*.^*~*.^~^**^*.
.~..*....~..~.***~..~^..~~^*^#^~^^~~**^.*~**^**^^*
^.*.~.^.**^*^.~^^*.~..*^~*^***#~**..^.~~*..^*^~*.~
^~~^~~*.~^^~~^**.^.^^^*^.*^^~~#^.*~^*^^..**..**..^
^.^*.*^..*.~~.^^***^.*~..~.**^*#~^...^^~*.~^~^..~~
~^^.^..*^^.**.~~^*~*^~*~^~~.~*#^~.~*^~*.*..^.^^*^*
^^.~*^~~*.~~*~.^..~*.^.~**.^*^#^~.**.~*.~...~~..*.
.~..^.~.~.^*.~^*~.~.*^*~~*.^.**#***~*~~*^~~~^.~~*~
~.*..^^*^~*.~~.~.^~..~.~^^^.*~*#**~^*~*^*^^~..^~^^
*.^*^**^*.^^*....**..~^^~.^*^.*~#^**^^..*.^^*^^^.~
^*^~^^*.~*~^*~^~~.*.^*^~*^^~.*~##~.**.*~^~~.~*^~~*
~~**~*.^.*~..~~^^^~^^^.~***^*.^*~#*~^~*~**...~..~.
*~**^~~.^.*.~^**~*^^.*^*.^~~*~~~*^#*..~~^*^.*^.^.*
.*^~..*~.*^^^^^~~^^*.~*.~~~.***~^.*##~~******~~^*.
.^^..^.^*^~^.~*...**~~~.**^*~~~*^***~##^~^~~^^^*.*
**.**~.**~.*.*^~~.~^.*^.~~*.^*.~.***~*^###~*.~*^*^
~..^.****^.****~^~***..^^^^*^.~*^^*.~~.^*#^*~^*.~~
^*~^.~*...^^.^~.^^..~^...**...^****^*~*~*^##~^*~.~
...^~^.~^^~~~~.*^~.^~***~~^^^.*^^.~.^*~*~**^#**^~^
.~~~~~^^.~~*^.~^^^**~^~.^~^~*..^*~^^*..*~^~**###^.
~^**.~**..*^~^^^.^*^~^~*^.~*~.^.**.^.^^.~**^~~^~##
